WWWWWWWWWWWWWWWWWWWWWWWWWWWWWWWWWWW
W.....B..............X............W
WFFFFFFFFLFFFFFFFF...L............W
W........LCCCCCCCCCCCL............W
W........L...........L....E.B.EEE.W
W........L.....FFL...FFFFFFFFFFLFFW
W........L.....FFL.............L..W
W.EEEEE..L.....FFL.........B...L..W
WFFFLFFFFF.....FFFFFFFFFLFFFFFFFFFW
W...L...................L.........W
W...L...E.......E.......L.........W
WFFFFFFFFFFLFFFFFFFFFFFFL.........W
W..........LCCCCCCCCCCCCL.........W
W.......EB.L............L.....B...W
W.....LFFFFFFF..........FFFFFFFFFLW
W.....L.........R....B...........LW
WFFFFFFFFFFFFFFFFFFFFFFFFFFFFFFFFFW
WWWWWWWWWWWWWWWWWWWWWWWWWWWWWWWWWWW
